OOOOOOOOOOOOOOONNOOOOOOOOOOOOOOO
OLLLLLLLLLLLLLLLLLLLLLLLLLLLLLLO
OLLLLLLLLLLLLLLLLLLLLLLLLLLLLLLO
OLLLLLLLLLLLLLLLLLLLLLLLLLLLLLLO
OLLLLLLLLLLLLLLLLLLLLLLLLLLLLLLO
OLLLLLLLLLLLLLLLLLLLLLLLLLLLLLLO
O##############################O
OLLLLLLLLLLLLLLLLLLLLLLLLLLLLLLO
OLLLLLLLLLLLLLLLLLLLLLLLLLLLLLLO
O##############################O
O##############################O
OLLLLLLLLLLLLLLLLLLLLLLLLLLLLLLO
O##############################O
O##############################O
OLLLLLLLLLLLLLLLLLLLLLLLLLLLLLLO
O##############################O
OS#############################O
OOOOOOOOOOOOOOOOOOOOOOOOOOOOOOOO