OOOOOOOOOOOOOOONNOOOOOOOOOOOOOOO
OLLLLLLLLLLLLLLLLLLLLLLLLLLLLLLO
OLLLLLLLLLLLLLLLLLLLLLLLLLLLLLLO
OLLLLLLLLLLLLLLPPLLLLLLLLLLLLLLO
OLLLLLLLLLLLLLLPPLLLLLLLLLLLLLLO
OLLLLLLLLLLLLLLLLLLLLLLLLLLLLLLO
OLLLLLLLLLLLLLLLLLLLLLLLLLLLLLLO
OLLLLLLLLLLLLLLLLLLLLLLLLLLLLLLO
O###OOO###OOO###OOO###OOO###OOOO
OLLLLLLLLLLLLLLLLLLLLLLLLLLLLLLO
OOOO###OOO###OOO###OOO###OOO###O
OLLLLLLLLLLLLLLLLLLLLLLLLLLLLLLO
O###OOO###OOO###OOO###OOO###OOOO
OLLLLLLLLLLLLLLLLLLLLLLLLLLLLLLO
OOOO###OOO###OOO###OOO###OOO###O
O##############################O
OS############################PO
OOOOOOOOOOOOOOOOOOOOOOOOOOOOOOOO